#tileset
Ressource/Sprites/spritemap.png
10 3
21 22
tile0: plein
#level
 3  8  8  8  8  8  8  8  8  8  4  8  8  8  8  8  8  8  8  8  5
16 29 29 29 29 29 29 29 29 29 16 29 29 29 29 29 29 29 29 29 16
16 29  3  8  5 29  3  8  5 29 26 29  3  8  5 29  3  8  5 29 16
16 29 23  8 25 29 23  8 25 29 29 29 23  8 25 29 23  8 25 29 16
16 29 29 29 29 29 29 29 29 29 29 29 29 29 29 29 29 29 29 29 16
16 29  7  8  9 29  6 29  7  8  4  8  9 29  6 29  7  8  9 29 16
16 29 29 29 29 29 16 29 29 29 16 29 29 29 16 29 29 29 29 29 16
23  8  8  8  5 29 13  8  9 19 26 19  7  8 15 29  3  8  8  8 25
19 19 19 19 16 29 16 19 19 19 19 19 19 19 16 29 16 19 19 19 19
 8  8  8  8 25 29 26 19  3  8 19  8  5 19 26 29 20  8  8  8  8
19 19 19 19 19 29 19 19 16 19 19 19 16 19 19 29 19 19 19 19 19
 8  8  8  8  5 29  6 19 23  8  8  8 25 19  6 29  3  8  8  8  8
19 19 19 19 16 29 16 19 19 19 19 19 19 19 16 29 16 19 19 19 19
 3  8  8  8 25 29 26 19  7  8  4  8  9 19 26 29 23  8  8  8  5
16 29 29 29 29 29 29 29 29 29 16 29 29 29 29 29 29 29 29 29 16
16 29  7  8  5 29  7  8  9 29 26 29  7  8  9 29  3  8  9 29 16
16 29 29 29 16 29 29 29 29 29 29 29 29 29 29 29 16 29 29 29 16
13  8  9 29 26 29  6 29  7  8  4  8  9 29  6 29 26 29  7  8 15
16 29 29 29 29 29 16 29 29 29 16 29 29 29 16 29 29 29 29 29 16
16 29  7  8  8  8 24  8  9 29 26 29  7  8 24  8  8  8  9 29 16
16 29 29 29 29 29 29 29 29 29 29 29 29 29 29 29 29 29 29 29 16
23  8  8  8  8  8  8  8  8  8  8  8  8  8  8  8  8  8  8  8 25